########## ###################
#                  ###########
#  ###             #######    
#  ###             #######    
#  ###             #######    
#  ###             #######    
#  ###                        
#  ###             #######    
#  ###                        
#  ###             #######    
#  ###             #######    
#  ###      V      #######    
#  ###             #######    
#  ###             #######    
#  ###             #######    
#  ###                  OO    
#  ###     ########P.         
#  ###             #######    
#  ###             #######    
######      ############## ###
#  ###                        
#  ###                        
#  ###             #######    
#  ###             #######    
#  ###             #######    
#  ###             #######    
#  #########       #######    
#  #########       #######    
#  #########       #######    
#                  #######    
