#############################
#P..........................#
#.####.#####.###.#####.####.#
#...........................#
#.####.##.#######.##.####...#
#......##....#....##........#
#####.#.####.###.####.#######
<     #.##       ##.#       <
#######.## ## ## ##.#########
      #   # R #   #          
#######.## ##### ##.#########
<     #.##       ##.#       <
#####.#.##.#######.##.#######
#............#..............#
#.####.#####.###.#####.####.#
#...##.......#.......##.....#
###.##.#####.###.#####.##.###
#...........................#
#############################