##################
<.....##.....O...>
#.###.##.##.###.##
#.#   #.##.#   #.#  
#.###.#.##.#.###.#  
#................#
#.###.########.### 
#.#   #.##.#   #.# 
#.###.#.##.#.###.# 
#.......P........# 
####.#.######.#.## 
   #.#   G    #.#  
####.#.######.#.### 
#.......R..V......# 
###################
