###################
#........#........#
#.##.###.#.###.##.#
#.................#
#.##.#.#####.#.##.#
#....#...#...#....#
####.### # ###.####
####.#       #.####
####.# ## ## #.####
<   .  #   #  .   <
####.# ##### #.####
####.#       #.####
####.# ##### #.####
#........#........#
#.##.###.#.###.##.#
#..#.....P.....#..#
##.#.#.#####.#.#.##
#....#...#...#....#
#.######.#.######.#
#.................#
###################