###################
#........#........#
#O##.###.#.###.##O#
#.................#
#.##.#.#####.#.##.#
#....#...#...#....#
####.### # ###.####
####.#       #.####
####.# ##V## #.####
<   .  #GR #  .   <
####.# ##### #.####
####.#       #.####
####.# ##### #.####
#........#........#
#.##.###.#.###.##.#
#O.#.....P.....#.O#
##.#.#.#####.#.#.##
#....#...#...#....#
#.######.#.######.#
#.................#
###################