##########.####<####<###################
#..................#####################
#..###.............#######.....#.......#
#..###.............#######.....#.......#
#..###.............#######.....#.......#
#..###.............#######.....#.......#
#..###..................................
#..###.............#######.....#.......#
#..###.............       .....#.......#
#..###.............#######.....#.......#
<..###.............#######.....#.......<
#..###.............#######.....#.......#
#..###.............#######.....#.......#
#..###.............#######.....#.......#
<..###.............#######.....#.......<
#..###.............#######.....#.......#
#..###.....########P....................
#..###.............#######.....#.......#
#..###.............#######.....#.......#
######......##############.#############
#..###.............       .....#.......#
#..###.......R.....       .....#.......#
#..###.............#######.....#.......#
#..###.............#######.....#.......#
#..###.............#######.....#.......#
#..###.............#######.....#.......#
#..#########.......#######.....#.......#
#..#########.......#######.....#.......#
#..#########.......#######.....#.......#
#..................#######.....#.......#
###########.###<####<#####.#############