#################
<...#...P...#...<
###.#.#####.#.###
###.#.#####.#.###
###.#.#####.#.###
#...............#
#.####.#.#.####.#
#.####.#O#.####.#
#.####.#.#.####.#
#...............#
####.## # ##.####
___#.       .#___
####.### ###.####
<....##V R##....<
#################
