#############################
#P.........................#
#.####.#####.###.#####.####.#
#...........................#
#.####.##.#######.##.####.#
#......##....#....##......#
#######.####.###.####.#######
<     #.##       ##.#     <
#######.## ##### ##.#######
      #   # R #   #
#######.## ##### ##.#######
<     #.##       ##.#     <
#######.##.#######.##.#######
#............#............#
#.####.#####.###.#####.####.#
#...##.......#.......##...#
###.##.#####.###.#####.##.###
#...........................#
#############################