##########.####<####<###################
#..................#####################
#..###.............#######.....#.......#
#..###.............#######.....#.......#
#..###.............#######.....#.......#
#..###.............#######.....#.......#
#..###..................................
#..###.............#######.....#.......#
#..###..............######.....#.......#
#..###.............#######.....#.......#
<..###.............#######.....#.......<
#..###.............#######.....#.......#
#..###.............#######.....#.......#
#..###.............#######.....#.......#
<..###.............#######.....#.......<
#..###.............#######.....#.......#
#..###.....########.....................
#..###.............#######.....#.......#
#..###.............#######.....#.......#
######......##############.#############
#..###.............#######.....#.......#
#..###.............#######.....#.......#
#..###.............#######.....#.......#
#..###.............#######.....#.......#
#..###.............#######.....#.......#
#..###.............#######.....#.......#
#..#########.......#######.....#.......#
#..#########.......#######.....#.......#
#..#########.......#######.....#.......#
#..................#######.....#.......#
###########.###<####<#####.#############