###################
#O.......#.......O#
#.##.###.#.###.##.#
#.................#
#.##.#.#####.#.##.#
#....#...#...#....#
####.### # ###.####
####.#       #.####
####.# ##V## #.####
<   .  # R #  .   <
####.# ##### #.####
####.#       #.####
####.# ##### #.####
#........#........#
#.##.###.#.###.##.#
#..#.....P.....#..#
##.#.#.#####.#.#.##
#....#...#...#....#
#.######.#.######.#
#O...............O#
###################