########## ###################
#                  ###########
#  ###             #######    
#  ###             #######    
#  ###             #######    
#  ###             #######    
#  ###                        
#  ###             #######    
#  ###                        
#  ###             #######    
#  ###             #######    
#  ###             #######    
#  ###             #######    
#  ###             #######    
#  ###             #######    
#  ###             #######    
#  ###     ########P       .. 
#  ###             #######    
#  ###             #######    
######      ############## ###
#  ###                        
#  ###       R                
#  ###             #######    
#  ###             #######    
#  ###             #######    
#  ###             #######    
#  #########       #######    
#  #########       #######    
#  #########       #######    
#                  #######    