###################
#        #        #
# ## ### # ### ## #
#                 #
# ## # ##### # ## #
#    #   #   #    #
#### ### # ### ####
#### #       # ####
#### # ## ## # ####
<      #RRR#      <
#### # ##### # ####
#### #       # ####
#### # ##### # ####
#        #        #
# ## ### # ### ## #
#  #     P  .. #  #
## # # ##### # # ##
#    #   #   #    #
# ###### # ###### #
#                 #
###################